Motorcade -- a parade of motor vehicles 
Apprehension  -- fear, anxiety, or custody 
Squalid -- very dirty, start with sq
Tenet --  principle , start with Te
Chronic -- last for a long time, repeated, start with Chr
Understaff -- not enough staff,
Inmate -- live together as a mate
Outage -- run out of sth
Socialite -- celebrity , start with social
Mogul -- prominent , star with Mog
Frigid -- cold , start with fri
Unsanitary -- unclean, but ends with tary
Beleaguered -- surround by league . 
Ecstatic -- adjectives of Ecstasy 
Shrapnel -- fragments of a missile or a bomb 
Perp walk -- taking the criminal to walk in public , start with Per
Hood -- a cloth like jacket without hat.
Sweatshirt -- a thick sport blouse  
Onlooker -- bystander, start with onl
Disincentive -- discourage , contain incent
Prowess -- skill or expertise	start with Pro
Manslaughter -- kill sb by mistake
Arson -- guilty of setting  a fire/inferno
Soak -- make sth wet 
Scrabble -- scratch around with one's fingers to find 
Rip -- tear down 
Triage -- lookin at the wounded and the ill and putting them into three categories, immediate treatment, to be deferred, or not worth treating
Reveller -- a person who enjoy himself in a lively or noisy way
Distraught -- frustrated , and anxious , start with dis
Influx -- rush into 
Distil -- a way to purify the liquid by heating it into gas, then cool down  
Contort -- distort , start with con

