Grinding -- oppressive and seemingly without end
Fresco --  a painting done rapidly in watercolor.
Preclude -- preventing for stopping something happens
Laud   -- praise , start with la
Allude -- suggest or call attention to indirectly
Barrage -- a concentrated artillery bombarment over a wide area  
Tenor - tone for man 
Devolve -- put sth down
Acrimony -- Vitriolic or ill feeling
Backdrop -- a painted cloth hung at the back of a theater.
Cement -- ingredient of concrete , enhance, 
Jolt -- shake, start with Jo
Prowl -- move around covertly
Browbeat -- threaten , intimidate . 
Bracket --  {}, ()
Loath -- unwilling , start with loa
Acquiesce -- accept something without protest
Skirmish -- small battle 
Tightrope -- tight rope
Fractious --  irritable , start with frac
Sharia -- Islamic moral 
Incentive -- a thing that encourages someone to do something
Evangelical  -- religious fervent which take the Bible seriously and believe in Jesus Christ as Savior and Lord.
Imposition -- noun of imposing 
Irk -- irritate , pique, three letter start with I
Blatantly  -- publicly, start with bl
Strait -- sea between two lands
Propaganda -- advertising of politics
Ire -- anger, three letters, start with I
Despair -- frustration 
Dilapidate -- very broken
Flimsy -- very thin, start with  fli
Waterlogged --  the bottom part is under water
Martyr -- die in religious way
Dire  -- very urgent, start win di
Pummel -- batter
Keg -- a small barrel 
Obstinate -- stubborn , start with ob
