prominent -- important people
reluctantly -- unwillingly 
Comply -- obey a law or rule
Bucking -- oppose, contradiction,  male of horned animals
Unanimous -- fully in agreement
Coincidence -- something happened in a rare odds
Sovereignty --  supreme  power or authority  to rule a territory 
Envoy -- a special man  who represents a prominent people, such as president, for meeting other foreign prominent people out of his country. A message.
Dispute -- disagreements, argument, debate.
Posture -- the position in which someone holds their body when standing or sitting
Conjure sth out of thin air--  make something out from nothing magically.
Exert -- give pressure into sb / sth?  She needs exert herself to try to find an answer.
Hail -- praise , usually for leader
Hardliner -- someone rigorously stick to something in a very tough way, uncompromising way 
Viral -- like a virus
Attire -- clothing
Retract -- draw back
Flout -- distain
Remorse -- deep regret  
Impetus  -- the force of body when moving, momentum..
Intervention -- interfere ?
Denomination -- autonomous province/church?
Sabre-rattling -- showing off by an army. 
Flare-up --  a sudden burst of flame/light/something.
Implication -- imply for something? The conclusion that draw something to happen when it is not explicit
Wall-to-wall -- continual , everywhere , full of floor?
Deluge -- a deluge of 
Compound -- a thing compose of two of more things. A Mixture
Aftermath -- a period after thing finished/ over
Rural -- outskirts , suburb, out of town ?
Plainly -- simply? 
Roam -- wander 
Veer -- change direction suddenly.
Reemerge -- appear again
Stance -- position/attitude about something
Ramp -- a slope or a declining plane joining for different level.
Off-Ramp -- a ramp you can go off from a high way.
Provocative -- adj, causing  someone strong reaction. 
Stoke --  add coal or other solid fuel to 
Sedition -- conduct or speech to inciting people against authority.
Traction --  an action of pulling drawing  something over surface, especially  in road or track
Spat -- small argument.
Retreat -- army go away , go back from frontline.
Commentary -- an article comment about an important things
Culpable -- deserve blaming
Furor -- an outbreak of public anger.
Unrest -- actions to make chaos ,   rebellious dissatification
Commission -- committee?	
Pique -- make sb angry ?
Atrocity -- an extremely brutal act at war, about killing injuring people.
Footage --  some  frames of a movie or video
Anti-Japanese Sentiment --  A feelings of hating Japanese for what they had done in the past.
Rigorous -- strict, hard 
Duct -- a pipe conduct liquid , gas to go through
National rejuvenation -- make the nation great again
Mar -- ruin, Break down , devastate of sth's face
Simmer -- just stay below the boiling point while heating . 
Croon -- hum or sing in soft.
Ecstasy --  a drug make your euphoria
Tilt -- slant , make a slope, move or move into a sloping position.
Impose -- force sb to accept something, give sb something they don't want it.
Frantic -- wild or distraught when fear , anxiety
A sweeping Shift -- Veer?
Acquit --  release by the court ? Free a man from a criminal charge by verdict of not guilty  
Morgue -- Mortuary, a place where store the dead body temporally before a funeral 
Wreak Havoc -- make serious damage , ruin or destruction
Blouse -- clothes worn in top half of women. 
Legitimate -- legal, lawful
Confiscate -- take away money of sb by law
Rhetoric  -- something said , described or bluffed by a politician.
Mortally --  fatally, lethally, very intensively or seriously.
Coalition -- a temporary team or group joined by many parties people , especially in politics.
Lavender -- a beautiful purple flower 
Cemetery -- a place all the grave are there. A burial ground, graveyard.
Forensic -- adjectives  about  doctor who examine the body for police or court.
Ballistic -- subject about the track of bullet. Arsenal ballistic
Manifestly -- clearly, definitely.
Devasted -- ruined
Enclave --  a place not connected with his government's mainland, you have to fly if you want to get there.
Evenhanded-- fair
Archly -- in an amused way that suggests you know more about something than someone else does
Endorse -- support someone publicly
Concede -- unwillingly admit something
Co-opted -- incrementally selected
Revolt -- rise in rebellion,  refuse to acknowledge.
Defy -- disobey the command or instruction openly, 
Euphoria -- sudden wildly happiness, ecstasy
Whistleblower -- the first person who warn the people in public when something bad happened.
Premise -- a previous statement from which another is inferred to conclusion. If the premise is true, than the conclusion is true.
Wriggle -- twist and move 
Obstruction -- blocking, try to stop/delay something
Unprecedented -- can not precede , never be seen before .
Inflict  -- cause someone to be suffered by someone/something.
Veto -- the power of president to deny the legitimate  measures or legislation.
Emerge -- appear
Foot-dragging -- Traction
Scrub  -- cleaning something by friction
Redact -- edit text for publication.
Fluster -- make someone anxious ,confused, in a mess
Morass -- messed up
Fostered -- raise sb/sth gradually. 
Scrutinize -- oversee 
oversight --an unintentional failure to notice something
Disastrous -- adjectives of disaster
Tremendous -- very big , great
Futility -- uselessness
Renouncing -- formally announcing for giving up or quitting
Entrench -- establish (an attitude, habit, or belief) so firmly that change is very difficult or unlikely.
Memorandum -- Memo
Vicious Cycle -- bad loop
Stringent -- strict , rigorous.
Pact --  a formal agreement between tow parties/countries.
Outpace -- faster than normal , big pace ?
Alienate --  cause someone to be isolated.
Catapult --  a forked stick with an elastic band fastened to the two prongs , use for children with stone to shoot small things.
Junta -- a military group which rule a country after taking the power by force.
Nix -- denial or refusal
Imperil -- endanger, jeopardize.
Secular -- religious, not connected with religious matters.
Coup -- an action to take power from current government by force.
Trumpet -- an instrument that like horn 
Strangle --  squeeze the neck of sb.
Exile --  the state of barred from someone's native nation, typically for political reason.
Sabotage -- deliberately destroy 
Cede Territory -- give up Territory.
Topple his Regime  -- take hist power away by a coup 
Intense -- very serious, strong feelings 
Sovereignty --  ruling a country 
Perennial -- sustain	 
Anticipation  -- get the conclusion before something really happens , prediction
Vital -- important, absolutely necessary
Buoyancy -- ability to float over water or air
Prospect -- likelihoop, hope.
Thwart -- obstruct 
Veracity --  truth, truthfulness
Concession -- take a step back in negotiation
Illicit -- forbidden by law, illegal.
Mekong -- a river in south east Asia
Leverage -- use a stick and support point to level up heavy things.
Devastate -- Damage, ruin
Meanders -- a river following a winding course
Tributary -- a river or stream following into a larger river or lake.
War-torn -- torn or damaged by war
Subsequent -- coming after something in time, following.. 
Unbridled -- uncontrolled, ridding a horse without bridle
Cynical -- disbelieve the common rule of normal society.
Contemplate --  think deeply
Flurry -- busy and  act but not organized or plan well, in hurry
Parliament -- House of British, 
Alluvial Mining -- a way of mining with water and soil
In-situ leaching -- an in position mining method
Heap leaching -- a way of mining with heap
Thriving -- prosperous
Intransigence -- refusal to changing opinion or anything , or agree about something
Flourish -- bloom? Prosper.
Ethnic --  national
Cyanide -- very poisonous chemical, can kill you in seconds
Arsenide -- poisonous chemical
Mercury -- liquid metal , it can volatilize , it can damage people badly when you accidentally inhale some of them.
Substantive -- very important, meaningful, considering
Cardiac arrest -- the heart stop in a sudden
Backstop -- a thing place at rear of other things to stop or support 
Strain --  pressure ? Exert Strain on someone?
Recrimination -- a responsive accusation to  an accusation from other 	
Manganese --  Manganese steel 
Naval  -- adjectives of Navy
Methamphetamine -- A illegal drug
Sodium Cyanide -- compound of sodium and Cyanide
Wrest -- forcibly  pull something  from someone's grasp.
Contaminants  -- things of pollution
Lucrative -- adjectives  for something that can make big money.
Ram -- a male sheep, push , buck
Infringe --  actively break the terms of law.
Curb --  a check or restraint something,  stone or concrete edge of street
Discriminating -- make a unjust or prejudicial distinction for things
Portrayals -- description by picture or animation?
Evasion -- action try to get rid of thing , or avoid to do 
Depict -- description by picture, portrayals
Covertly -- secretly 
Infiltration -- an action that entering an organization covertly.
Subversion -- an action to take power from current government.
Monetize -- make money from something, knowledge
Discern -- recognize 
Entice  -- attract or tempt by offering pleasure or advantage	 
Vigilant -- be wary of 
Espionage -- action by spies
Peculiarity -- an odd feature.
Somber -- dark in color.
Evade --   avoid , escape
Gross negligence -- guilty for not doing enough and good job for avoiding something happen.