Perish -- suffer dead  suddenly.
Thug -- a bad guy
Inferno -- big fire
Afflict -- make someone suffer or painful
Incumbent -- be currently in a position 
Guerrilla -- an arming fight in style of running and hiding after  fighting
Engulf -- surround
Cocoon -- A silk case spun by silkworm
Refurbishment -- redo  decoration of a house
Cessation -- termination
Combustible -- inflammable, very easy to get fire
Scrutiny -- oversee, look into carefully 
Prerequisites  -- condition must be met before doing
Cultivate -- farming
Undermine -- subvert in secret
Oven --  a case for baking
Assailant -- a person physically attack someone
Viable -- properly successful, have a chance to make success
Trauma -- badly hurt mentally
UniLateral -- single side
BiLateral -- two sides,
Tenement -- a room has a toilet inside 
Apparatus -- technical equipment
Billow -- smoke / steam
Unambiguous -- clear, not ambiguous
Traumatic -- adjectives for trauma
Fume -- make something smoking 
Consolidate -- make stronger in physical or solid
Erode -- gradually wear away  by wind 
Erect -- upright, straight, vertical
Circumstance -- momentum
Erosion -- noun of Erode
Bustling -- walk in hurry
Exterior -- outside of building 
Interior -- inside of building
Humanitarian --  someone dedicated to promoting human welfare
Catastrophe  -- disaster 
Culminate -- terminate, go to the end
Alleviate -- relief
Prone   -- likely to suffer from sth
Deterioration -- getting worse
Palpable -- can almost reach to 
Moral -- concerned with principles of wrong and right behavior
Imperative -- important and urgent
Abstention -- an instance of declining to vote
Heartstring -- use to reference in someone deepest feeling 
Fatigue  -- extreme tireness of metal 
Benign  -- be nice
Renaissance -- happened in the middle century of Europe about culture , art , science  all come back and make a great progress.
Tourniquet -- a brand to stop bleeding 
Pristine -- brand new
Meteorite --  stone from outer space which fall into earth
Bystander -- someone standing there and watching
Oust -- drive out or expel someone from a position/place
Epitomize -- to be a perfect example
Tout -- attempt to sell
Blast -- explode
Surveillance  -- close observation. 
Fumble -- use the hands clumsily while doing sth.
Deity -- godess
Contamination -- pollution 
Drug Cartels -- group of drug trafficker
Nacro-War  -- drug war
Fertile -- very suitable for growing abundant plants
Vicinity -- places nearby 
Artillery -- large gun
Tentative -- temporary, not certain yet
Demoralize -- loss confidence about something
Cosmetic -- stuff or products for making up
Affiliate -- officially attach or connect to 
Munition -- military weapon
Indigenous -- locally
Hormone imbalance -- not balance in Hormone
Apprehend -- arrest someone for crime
Reconnaissance --  job of scout
Ingredient -- Source Material to make something
Supernova --  super new star 
Stimulate --  raise levels of physiological or nervous  activity 
Curator -- top manager of museum
Aeronautics -- science of building airplane
Surmise -- suppose that something is true without evidence
Superintendant	-- supervisor
Tow -- drag /pull
Molecule -- a group of atom bonded together
Stem from -- the reason about something bad 
Trudge -- Walk very hardly and tiredly
Stagger -- Walk in way unstable.
A myriad of  -- a lot of 
Androgenetic  alopecia -- illness of genetic losing hair
Wean -- get rid of some drug / medicine
Imminent -- about to happen
Delve  -- hunt , explore
Speculation -- guessing 
Feckless  -- irresponsible
Huddle -- crowd together.
Tactics -- strategy
Coerce -- force sb to do sth
Lure -- tempt sb to do sth or go something
Bribery -- ask some to do sth for someone by giving him money or property, expensive things
Fiasco -- defeat badly
Far-flung --far away
Orchestrated -- plan carefully without anything missing to make sure it can be done 
Guise -- false appearance
Bolster -- enhance ,grow 
Setback -- failure 
Retribution -- revenge
Prosecution -- accuse someone by law 
Hastily --in hurry, Flurry
Indictment  -- a formal charge for crime
recipe -- a set of instructions to prepare a dish, including the ingredients
Ideological -- ological about idea
Initiative -- starting , beginning, draft?
Demographic -- population statistic
Retroactively  -- can source back to 
Haphazard -- in a mess
Hyper -- very excited , exceeding
lash out with -- serious question or criticize about something
Constitutionally -- in way of constitution
Deprive -- take away 
Wary -- Vigilant 
Omnipotence  -- all power
Fray -- wear out 
Subsidies -- compensation by money
Relentless -- endless 
Incriminate -- prove sb criminal
As a last resort -- the final action you can do about something
Startling -- stunning 
Critics -- action of criticizing
Presage -- noun, a sign or warning something  bad will happen
Reel -- twine 
Harsh -- rigorous 
Behest -- command 
Obstruct -- block
Abuse -- treat someone badly with violence
Globetrotting	
Frustration -- very disappointed 
Turbulent -- very difficult, up and down
Paraphrase -- express the meaning of an article
Allege -- it is said
Courageous -- adjectives of courage
Creep -- Thug
Momentarily -- for a short time
Prolong -- keep a long time, make it longer
Deflect -- cause sth to change direction by interposing sth
Trafficker -- bad guy of selling people or bad things 
Revolt -- refuse to acknowledge
Vindication -- justice for someone
Maneuver -- a way to do political thing
Lockstep -- after one step, 
Deluge -- a severe flood
Unfettered  -- un controlled
Intrigue -- interesting
Sustain  -- keep doing 
Hoax --  drama
Stretcher  -- a simple bed to carry the patient
Disdain -- felling that something is unworthy of one's consideration or respect
Vigil -- activity to commemorate victims by holding candle at night 
Skeptical -- doubt, suspicious
Stunning -- startling
Varying -- differing in  size , amount,  degree or nature.
Radioactive -- can emit radio 
Seismic --  adjectives about earthquake
Wield -- swing , wave
A lame duck  -- President against by his own party 
Dominance -- power of influence over sth/sb
Caucus -- meeting of political parties
Grassroots -- grow from in a poor or unwealthy family
Adamant  -- refusing to be persuaded
Pliant -- easy to blent
Disproportionately  -- in a very unbalanced ratio
Unappetizing -- unable to eat , because look or taste too badly
Perception -- an ability to be aware of something by senses
Spectacular -- amazing, usually describe a building , landscape.
Weigh on  --o cause worry, sadness, or distress to someone.
Reiterated -- tell again to confirm 
Shatter --  break up
Intractable -- very difficult to resolve 
Bogs -- muddy pool
Uproar -- public roar
Statute -- law
Conservative -- averse to change 
Acute -- intense
Persecute  -- incriminate innocent  someone
Infallibility -- quanlity of being infallible
Consciousness -- mind
Looming -- (event) seemingly about  to happen
Reimburse  -- repay
Flip-flop -- a sweeping change direction 
Defuse  -- remove fuse

