Jurisdiction -- controlling by law justice	
Contend -- fight in political way, start with con
Plausible -- can be trusted , start by pla
Commerce -- trade , start by com
Preposterous  -- strange, start with pre
Salvo -- a series of  questions  
Pepper -- spicy food start with p
Depose -- make sb dethroned
Veneer -- cover, pretending , start with Ve 
Intervene  -- adverb of intervention 
Hull -- shell of ship. 
Interdict -- forbid , ends with dict
Discrepancy  -- difference, margin 
Inauspicious  -- looks not good for luck , well being or ongoing of sb or sth
Lap -- one circle of the track of racing
Shrug -- posture to show doubting by raising shoulders
Exacerbate --  Aggravate, start with Ex
Fissure  -- rift on something, start with F
Neocons -- new conservative 
Quagmire -- swamp, start with Qu
Gob -- mouth , start with G
Paramount -- param that is the first and core 
Disarray -- does not in array
Upheaval -- unrest, start with up
Expropriation -- confiscation , start with exp
Blockbuster -- very popular, start with bl
Covet -- greedy seeking for , start with C
Pervasiveness -- the quality of spread widely 
Clad -- wear 
Full-fledged -- full of capacity and ability
Afterthought  -- thinking after what happened 
Prevalence  -- popularity  , start with pre
Assuage -- relief, alleviate. Start with as
Bulk -- very large number 
Hypocrisy --  pretending of kindness or charity , fake kindness  or justice.
Parrot -- a bird can mimic human speaking
Deterrence -- an action to discourage sb to do sth
Afield -- a filed that far away from 
Brazen -- act as no shame 
Decapitate -- cut sb's head
Swoop -- dive down in the sky , start with sw
Pinnacle -- peak , start with pi
Remnant -- remains , end with ant
Revile -- criticize , start with Re
Dip  --  put down into water to soak 
Bellicose -- adjectives  of bellicosity 
Delusion -- illusion that is ill or displaced
Ebullient --  cheerful and full of energy 
Beefed-up -- enhanced , start with beef
Cataclysmic -- adjective  of catastrophe  
Bedrock -- a rock forming the base
Obliterate -- eliminate, start with ob 
Snatch -- grab , take sb away by force, start with sn

 