Adversary -- opponent , start with adv
Disposal -- processing, dealing with, selling out, start with dis
Rebuff -- reject strongly
Lob -- throw or hit a ball in a high 
Demean -- low down one's position of society or politics 
Instigate -- start sth, start with inst
Whitewashed -- wash something to make it white from black
Troll --  offend, start with T, it is also  mean a monster in noun
Baseless -- without bedrock
Throng  -- a swarm of people 
Transpire -- be revealed 
Cowardice -- coward action
Villain -- bad guy, start with vi 
Oft-repeated -- repeated the true
Aberration -- uncommon thing or event, off normal direction
Commute -- travel to work.
Redeploy -- coordinate, end with deploy
Stockpile -- stock and pile in the storage for emergency 
Deplete -- run out of , start with de, contrast to complete
Suburban -- sub urban, outskirts, 
Veranda -- passage , start with Ve
Venue -- a place for sport games
Ploy -- strategy , start with p
Forthright -- candid, start with For
Nimby -- who don't want anything to happen
Scrap -- stop, turn into pieces ,  its noun is equal fragment 
Loom large -- to be worried
Precinct -- area for walking 
Buckle under -- short phrase, start with bu,  succumb .
Paranoia -- full of skeptical thoughts 
Mercenaries -- only for money 
Agitator -- a person who urge others to protest or rebel . a tool to mix ingredients up  
Rioter -- people attending unrest
Cripple -- noun about sb whose legs have problem, so one has to hobble
Formidable -- hard to deal with, start with form
Averse -- strongly disagreed , a little hateful.
Ruse --  trick, start with R

