Curtail -- reduce, end with tail
Affidavit -- commitment paper 
Cartridge -- a casing containing bullets
Caliber -- the size of gun
Auditorium -- a hall holding  big ceremony in school 
Detonate -- go to explode
Zionists -- a ideologist  that Jew want to recover their  country  as size as the size  in a very old time before century
Meticulously -- Orchestrated planning 
Footbridge -- a bridge only for people pass on foot
Descend -- go down .
Correctional -- relating to the. punishment of criminals in way intended to rectify their behavior.
Boo -- make noise to show protesting on who is attending a public actives, like speech.
Whilst -- equal to while A 
Aggravate -- make sth worse 
Groom -- a man about to be a husband, a men who take care of horse , for verb,  equal brush or clean the coat
Scramble -- move by both hands and feet
Convene -- call people for a meeting
Session --  meeting, conversation , start with s
Chassis --  the ground part of a car
Batter -- bit or bit , start with ba
Trove -- a store of valuable things.
Contempt -- flout 
Ream	-- 500 papers of documents 
Ramification  -- consequence, start with ram
Unequivocal --  not obscure at all 
Quell -- relief start by qu
Vortex -- a mass of whirling of water or wind
Sheer -- adequate, totally, start with She
Beset -- disturb , start with Be
Incessant -- continuing without interruptions , unceasing 
Zeal -- ferventing but not about religious, enthusiasm, start with Z
Dilemmas -- a embarrassing situation 
Grip -- equal to grasp, also start with gr
Potency -- power , start with pot
Interference -- Intervention
Undercut -- offer goods in lower price
Censure --  C + ensure is for condemn?
Diminish -- reduce, make it more and more mini
Premature -- not grow up yet, far before mature
Appropriations -- illegally move the cake
Modicum -- little , start with Modi
Accomplice -- criminal who collude with other
Hubris -- self center , proud of oneself, act or think oneself excellent but without enough ability 
Atonement -- do something to make up for the mistake , redemption

