Insignia -- badge for identification, start with I
Outstrip -- outpace, end with p
Optic -- about eye, start with O
Sinister -- evil, start with sin
Chalk up -- a soft limestone used to write letters in the black board
Nexus -- connection, start with nex
Swastikas --  a famous Nazi's Insignia
Lore -- legend, start with L 
Subculture -- subclass of culture
Bandanas -- a scarf with  flower or pattern on it 
Prospect -- hope , start with Pr
Nefarious -- evil, start with Nef
Fraternity -- friendship, start with Fra.
Marginalize -- alienate , start with Margin
Notorious -- very bad reputation , every one knows 
Syndicates -- a famous gang
Turf -- grass land
Rivalry -- competition , begin with Ri
Riddle -- make small holes in a plane , often by bullets
Standstill -- a state everything stopped 
Impede -- stop sb , start with imp
Sanctity -- thing of sacred 
Overt -- the opponent  of  covert , means public
Nuisance -- event you get in trouble.
Pragmatic -- Pratical , realistical 
Emblems -- Insignia, badge , start with Em
Brandish --  wield a big stick in public
Advocate -- supporter , start with Adv
Crimson -- deep red.
Overhaul -- take apart in order to examine and repair it in necessary 
Theatrical -- adjectives, like an action in a theater. 
Segregation -- action of separating  people  by color or gender
Plunge -- jump down, start with Plu
Precipitous -- in a very tough angle downward or upward
Conscription -- tell people to do  enrollment to army. 
Waned -- become small or bad 
Despise -- disdain , start with des
Rabbinical -- a jewish law 
Patriarchy -- a system of society which govern by father or elder man
Alimony -- fee paid for  raise baby after divorce
Proponent -- people who support and conduct sth to carry on
Entangle -- involve, stuck by a rope
Ordeal -- suffering, start with ord
Estrange -- no longer close to 
Institution -- a school, or a traditional rule
Consent -- agreement, start with con
Pro-natalist -- encouraging people to have more children
Profound -- huge, start with prof
Surge -- a sudden feeling of emotion
Femicide -- killing women/female
Indifferent --  unconcerned , start with ind




