Paedophile -- a criminal offense young man/woman or child
Caveats -- warning , start with Ca
Redacted -- blockout the sensitive contents
Novelty -- noun , feeling of reading a novel
Caricature -- the drawing style like cartoon
Satire -- the use of irony, humor, parody to expose sb's stupidity 
Filthy -- dirty, start with fi
Fundraising -- fund raising 
Nudity -- noun of naked, nude  
Debunk -- reveal the truth 
Appalled -- greatly dismayed or horrified
Racket -- the badminton paddle
Ascertain -- be certain after investigation 
Waver -- disappear, start with wa
Affection -- soft feeling of liking
Upmarket -- hight position in market, high class 
Precarious -- unstable, depends on chance
Stupefy -- too stunning to think, numb
Dubious  -- hesitating or doubting
Obtrusive -- looks odd, start with ob
Withholding -- refusal to unleash
Subpoena  -- ticket from court to ask to take part in a case 
Reverberate -- resound / echo / resonate
Be sacked -- be fired from one's job/position
Utterly -- completely, start with Ut
Plight -- dilemmas, difficult state of living.
Candid -- straightly, frankly and honestly , start by can
Fortress -- important defense facility
Fortify -- make it as a fortress
Envisage -- envision
Reinstatement -- the action of giving someone back a position they lost before.
Rescind -- revoke, or cancel , start with res
Referendum -- voting and deciding by all citizens 
Counterproductive -- not productive, or do harm to productive that it should be 
Settler -- people about to relocate , start with set
Outpost --  a small military camp 
Disengagement -- the withdrawal of military forces, contains engage
Unwavering -- will not disappear , with a word waver
Lead-up -- a event, start with lead
Demolition -- break down a building, verb demolish
Inconsistent -- not consistent 
Impunity  -- avoiding from punishment 
Prevail -- become popular 
Perpetrators -- criminal , start with per
Ample -- adequate , enough , start with am
Monroe Doctrine --  a us policy 
Revamp -- renew , ends with amp
Incursion -- attacking, start with Inc
Spark -- debris or flowers of fire when the fire exploding
Blunt --  not sharp
State-backed -- backed by state
Maritime --  marine transport
Amass -- gathering into very big mass 	
Vie -- compete , start with v
Corollary -- a definite sequence.
Staunch -- adamant 
Spiral  -- winding in a continually and gradually widen curve
Flex -- bend, start with fl
Excessive -- too much, too deep, start with exc
Dean -- charger of a college, principal of a college
Retrenchment -- hold tightly back again
Evocation  -- an action of recalling  of feelings, start with evo  
Bygone -- gone long time ago

