Sever -- cut off
Grisly -- hor1ror, terrified, start with Gr
Interrogation  -- ask question by police
Magnate  -- big organization , start with Mag
Rugged  -- adjectives for complex terrain with many mountains
Plier -- tool to clamp things 
Shackle -- tow steel circles with lock to wear on the criminal's two hands for precluding run away or fight back . Like chain.  Similar to Fetters which applied to foot
Heir -- one takes the heritage
Crony -- close friend
Henchman -- a man is trusted by someone
Duress -- oppression , start with du
Proliferate -- surge
Ensnare  -- lure , start with en
Extradite -- transfer criminal from one country to another 
Lifeline -- line of life
Wedge -- force into a narrow space
Burmese --  Myanmarâ€™s
Glitter -- sparkle  , start with gl
Defraud -- cheat , start with def
Conned -- cheated , start with co
Patriarch -- chief of a family
Cadre -- pillar of an organization 
Conglomerates -- cooperations, start with con
Murky -- dark, start with M
Wade -- go into water
Dethroned  -- ousted leader
Den -- cave for people, start with d
Ringleader -- the head of criminals
Jig -- a dance start with J
Extortion -- blackmail, start with Ex
Kingpin -- hinge , start with Ki
Municipal -- civil , start with Mu
Stalwart  -- adamant , staunch,  start with Sta
Bellicosity -- charateristics of enjoying fighting	
Make sb raise hackle -- infuriate , end with kle
Muster -- assemble , start with Mus
Plunder -- rob, start with pl
Prudent -- act with care, 
Cling -- grab, start with cli 
Stranded -- left without means to move 
Chic -- fashion
Pared-back -- simple style
Bellwether -- a leading goat of a group of goats wearing a bell 
Sleek --  smooth and shining 
Brooch -- pin for decroration 
Voluminous  -- oppose to tight while wearing clothes.
Glamour -- full of charming 
Archival -- to be archived 
Shimmer  --  sparkle or glitter , start with sh
Vintage  -- reminiscent style of clothes, start with Vi
Tux -- abbreviated tuxedo
Peninsula -- half island 
